 0  0  0  0  0  0  0  0  0  0  0  0  0  0  0  0  0  0  0  0
 0  0  0  0  0  6  1  1  3  0  0  0  0  0  0  0  0  0  0  0
 1  1  3  0  0  2  0  0  2  0  0  6  1  3  0  0  0  0  0  0
 0  0  2  0  0  2  0  0  2  0  0  2  0  2  0  0  0  0  0  0
 0  0  2  0  0  2  0  0  2  0  0  2  0  2  0  0  0  0  0  0
 0  0  2  0  0  2  0  0  5  1  1  4  0  2  0  0  0  0  0  0
 0  6  4  0  0  5  3  0  0  0  0  0  0  2  0  0  0  6  1  1
 0  2  0  0  0  0  2  0  0  0  0  0  0  2  0  0  0  2  0  0
 0  2  0  0  0  0  2  0  0  0  0  0  0  2  0  0  0  2  0  0
 0  2  0  0  0  0  2  0  0  6  1  1  1  4  0  0  0  2  0  0
 0  5  1  1  1  1  4  0  0  2  0  0  0  0  0  0  0  2  0  0
 0  0  0  0  0  0  0  0  0  5  1  1  1  1  1  1  1  4  0  0
 0  0  0  0  0  0  0  0  0  0  0  0  0  0  0  0  0  0  0  0
 
 0  0  0  0  0  0  0  0  0  0  0  0  0  0  0  0  0  0  0  0
 0  0  0  3  0  1  1  1  1  0  0  0  0  0  0  0  0  0  3  0
 1  1  1  0  0  1  0  0  1  0  0  1  1  1  0  0  0  0  0  0
 0  0  1  0  0  1  0  0  1  0  0  1  0  1  0  0  2  0  0  0
 0  0  1  0  0  1  0  0  1  0  0  1  0  1  0  0  0  0  0  0
 0  0  1  0  0  1  0  0  1  1  1  1  0  1  0  0  0  0  0  0
 0  1  1  0  0  1  1  0  0  0  0  0  0  1  0  0  0  1  1  1
 0  1  0  0  0  0  1  0  2  0  0  0  0  1  0  0  0  1  0  0
 0  1  0  2  0  0  1  0  0  0  0  0  0  1  0  0  0  1  0  0
 0  1  0  0  0  0  1  0  0  1  1  1  1  1  0  0  0  1  0  0
 0  1  1  1  1  1  1  0  0  1  0  0  0  0  0  0  0  1  0  0
 0  0  0  0  0  0  0  0  0  1  1  1  1  1  1  1  1  1  0  0
 0  0  0  0  0  0  0  0  0  3  0  0  0  0  0  0  0  0  0  0